You can't believe you've finally made it. It seems like forever since you boarded the small rocket. Your journey from Earth to the planet ____ has taken almost a year, even though you were traveling as close to light speed as is possible. You were chosen from random lottery to be sent to the new colony on ___ because Earth is falling apart due to climate change and dwindling resources. It is time to start your new life on this great new planet. However you should probably put on your gear first.

Space IF (Title pending)
An Interactive Fiction by W.K.
Release 1 / Serial number 150401 / Inform 7 build 6L38 (I6/v6.33 lib 6/12N) SD

Rocket Interior
The interior of the rocketship is almost entirely white. There is a cramped cot built into one side of the room with a small nightstand next to it. On the opposite side of the room is a small cubicle that leads to the bathroom. Taking up most of the space in the rocket is a chest in which you have been keeping all of your personal belongings. Across from this chest is the hatch that leads to outside of the rocket.

You can see Chest (in which is Uniform) here.

>examine rocket
You can't see any such thing.

>look
rocket
The interior of the rocketship is almost entirely white. There is a cramped cot built into one side of the room with a small nightstand next to it. On the opposite side of the room is a small cubicle that leads to the bathroom. Taking up most of the space in the rocket is a chest in which you have been keeping all of your personal belongings. Across from this chest is the hatch that leads to outside of the rocket.

* * *

>w d
I only understood you as far as wanting to (go) w.

>w down
I only understood you as far as wanting to (go) w.

>walk down
Rocket Bathroom

* * *

>walk down
You've already done everything you have to in there today.

* * *

>examine chest
In Chest is Uniform.

>take uniform
Taken.

>inventory
You are carrying:
  Uniform

* * *

>take uniform
Taken.

>examine uniform
A neatly folded blue uniform that every new member to the colony wears amongst all of the other clothes you have been wearing on your journey.

* * *

>open chest
It isn't something you can open.

>examine chest
In Chest is Uniform.

* * *

>take uniform
Taken.

>wear uniform
You put on Uniform.