It is the year 2315, you are an astronaut who embarks on a journey a new planet, due to overpopulation and climate change destroying valuable resources on Earth. The planet is located in a different galaxy and accessible only through a wormhole. The planet, Xuria, has been found to be teeming with exotic plant life, quite habitable compared to Earth.

---------------------------------------------------------------------------------------------------------------

You can't believe you've finally made it. It seems like forever since you boarded the small rocket. Your journey from Earth to the planet Xuria has taken almost a year, even though you were traveling as close to light speed as is possible. You were chosen from random lottery to be sent to join the experimental colony on Xuria because Earth is falling apart due to climate change and dwindling resources. It is time to start your new life on this great new planet. However you should probably put on your gear first. There might be fire or sharp fragments of the ship outside after that rough landing.

Welcome
A Space Journey
Release 1 / Serial number 150412 / Inform 7 build 6L38 (I6/v6.33 lib 6/12N) SD

Mid Deck
The interior of the rocketship is almost entirely white. There is a cramped cot built into the east side. On the west side of the room is a small cubicle that leads to the bathroom.  On the other side of the room is a ladder leads to the flight deck above and a lower deck below. A brochure of the rocket is pinned onto the wall.

You can see Brochure and Computer here.

>walk e
Your Room
The majority of space in the room is taken up by the chest that you kept all your belongings in. Next to your makeshift "bed" is a small nightstand.

You can see Chest (closed) and Nightstand (on which are a lamp and a drawer (closed)) here.

>open drawer
You open the drawer and see wrappers from the candy bars you smuggled onto the ship before you departed and inevitably ate within the first month, despite telling yourself you would save at least one for when you reached your destination. Under the wrappers you can see something made of plastic.

You open the drawer, revealing candy wrapper and ID card.

* * *

>take all
candy wrapper: Taken.
ID card: Taken.

>walk w
Mid Deck
The interior of the rocketship is almost entirely white. There is a cramped cot built into the east side. On the west side of the room is a small cubicle that leads to the bathroom.  On the other side of the room is a ladder leads to the flight deck above and a lower deck below. A brochure of the rocket is pinned onto the wall.

You can see Brochure and Computer here.

>walk d
Lower Deck
There is a hatch on the side where you can leave the ship. The lower deck is large and filled with rooms you don't care about. There is a ladder where you climbed down from the mid deck.

You can see Ship door here.

>open door with card
You unlock Ship door.

>open door
You open Ship door.

>walk n
parking lot
You look around you and see a surprising amount of vegetation. Its amazing how similar Xuria's atmosphere is to Earth's. You are in a parking lot for space ships. The lot is empty except for an old spaceplane. The crash site is where the radio antenna array was. A shame that its now burnt to a crisp after the crash. To the North you can see some buildings that almost certainly make up the colony.

You can see Ship door and Spaceplane (empty) here.

>enter spaceplane
The door is partially disassembled. Even if you could get in, it's not flyable like this. Maybe if you knew where the parts were and how to put it back together...

>examine spaceplane
It is a Boeing type 929-200, a triple-warp-drive ancient relic from decades past. you used to pilot that thing for a sketchy galactic freight operator years before I took a job with the government. You just can't kill that that thing, not even with years of neglect. They just don't build "em like they used to. This one seems to be in a relatively good condition, compared to the ones on your last job, at least.

* * *

>examine computer
You see nothing special about Computer.

Enter username :

>john12
Password :

>CoHOBaSt
john12@TownHall-02:/home/john12/$

>getKnowledge
0
john12@TownHall-02:/home/john12/$

>ls
At: /home/john12/
Contain folder: Download and Documents
Contain file: 

john12@TownHall-02:/home/john12/$

* * *

>ls
At: /home/john12/Download/
Contain folder: B979Manual
Contain file: 

john12@TownHall-02:/home/john12/Download/$

>cd B979MAnual
Can't do that
john12@TownHall-02:/home/john12/Download/$

>cd B979Manual
john12@TownHall-02:/home/john12/Download/B979Manual/$

* * *

>ls
At: /home/john12/Download/B979Manual/
Contain folder: 
Contain file: FCOM.txt and MxManual.txt

john12@TownHall-02:/home/john12/Download/B979Manual/$

>cat FCOM.txt
-----
A very long text that sounds more and more familar as it brings back your memories from your freight dog days...
-----
john12@TownHall-02:/home/john12/Download/B979Manual/$

>getKnowledge
1
john12@TownHall-02:/home/john12/Download/B979Manual/$

>cat MxManual.txt
-----
Door should be installed with the up arrow pointing up and the inside label facing inside. Use No. 12 spanner to tighten the hinge bolt. Put grease (P/N:1102) onto the hinge. Do not use mayonaise for this task. Horseradish is not allowed, either.
-----
john12@TownHall-02:/home/john12/Download/B979Manual/$

>getKnowledge
2
john12@TownHall-02:/home/john12/Download/B979Manual/$

* * *

>checkKnowledge
That's not a verb I recognise.

>checkKnowledge
That's not a verb I recognise.

* * *

>jump
OrangeDay:false, DeathRate:false, Computer:false
CheckKnowledge RAN

>examine computer
You see nothing special about Computer.

CheckKnowledge RAN
Enter username :

>john17
Bad Username

>examine comuter
You can't see any such thing.

>examine computer
You see nothing special about Computer.

CheckKnowledge RAN
Enter username :

>john12
Password :

* * *

>CoHOBaSt
john12@TownHall-02:/home/john12/$

>cd Documents
john12@TownHall-02:/home/john12/Documents/$

>ls
At: /home/john12/Documents/
Contain folder: 
Contain file: BlogDraft.txt

john12@TownHall-02:/home/john12/Documents/$

>cat BlogDraft.txt
-----
... Just look at the death rate here. On the date ##, the number of death was suddenly zero. ... This may offer an important clue toward the cure for this bacteria. We may need to look into what happened on that day. ...
-----
john12@TownHall-02:/home/john12/Documents/$

>cd ..
john12@TownHall-02:/home/john12/$

>cd Download
john12@TownHall-02:/home/john12/Download/$

>cd B979Manual
john12@TownHall-02:/home/john12/Download/B979Manual/$

* * *

>cat FCOM.txt
-----
A very long text that sounds more and more familar as it brings back your memories from your freight dog days...
-----
john12@TownHall-02:/home/john12/Download/B979Manual/$

>cat MxManual.txt
-----
Door should be installed with the up arrow pointing up and the inside label facing inside. Use No. 12 spanner to tighten the hinge bolt. Put grease (P/N:1102) onto the hinge. Do not use mayonaise for this task. Horseradish is not allowed, either.
-----
john12@TownHall-02:/home/john12/Download/B979Manual/$

>getKnowledge
3
john12@TownHall-02:/home/john12/Download/B979Manual/$

* * *

>jump
OrangeDay:false, DeathRate:false, Computer:false
CheckKnowledge RAN

>jump
OrangeDay:false, DeathRate:false, Computer:true
CheckKnowledge RAN

>jump
OrangeDay:false, DeathRate:false, Computer:true
CheckKnowledge RAN

* * *

>look
Mid Deck
The interior of the rocketship is almost entirely white. There is a cramped cot built into the east side. On the west side of the room is a small cubicle that leads to the bathroom.  On the other side of the room is a ladder leads to the flight deck above and a lower deck below. A brochure of the rocket is pinned onto the wall.

You can see Brochure and Computer here.

CheckKnowledge RAN