It is the year 2315, you are an astronaut who embarks on a journey a new planet, due to overpopulation and climate change destroying valuable resources on Earth. The planet is located in a different galaxy and accessible only through a wormhole. The planet, Xuria, has been found to be teeming with exotic plant life, quite habitable compared to Earth.

---------------------------------------------------------------------------------------------------------------

You can't believe you've finally made it. It seems like forever since you boarded the small rocket. Your journey from Earth to the planet Xuria has taken almost a year, even though you were traveling as close to light speed as is possible. You were chosen from random lottery to be sent to join the experimental colony on Xuria because Earth is falling apart due to climate change and dwindling resources. It is time to start your new life on this great new planet. However you should probably put on your gear first. There might be fire or sharp fragments of the ship outside after that rough landing.

Welcome
A Space Journey
Release 1 / Serial number 150416 / Inform 7 build 6L38 (I6/v6.33 lib 6/12N) SD

Mid Deck
The interior of the rocketship is almost entirely white. Your room is on the east side. On the west side of the room is a small cubicle that leads to the bathroom.  On the other side of the room is a ladder leads to the flight deck above and a lower deck below. A brochure of the rocket is pinned onto the wall.

>examine brochure
"The all-new Gulfstream G9800 space plane offer the best performance in the small suboptic transport class. With the top speed of 0.98C, the highest in class, and unbeatable fuel economy from our twin wormhole energizer, You are guaranteed to arrive at your space colony faster than anyone while still spending less on fuel."
 All that performance was paid for with reduced structure, something you just discovered the hard way on the crash landing.

>d
Lower Deck
There is a hatch on the north side where you can leave the ship. The lower deck is large and filled with rooms you don't care about. There is a ladder where you climbed down from the mid deck.

You can see Ship door here.

>u
Mid Deck
The interior of the rocketship is almost entirely white. Your room is on the east side. On the west side of the room is a small cubicle that leads to the bathroom.  On the other side of the room is a ladder leads to the flight deck above and a lower deck below. A brochure of the rocket is pinned onto the wall.

You can see Brochure here.

>u
Through the jammed door, you saw a large pool of blood and guts on the floor. You see no point in opening the cockpit door and seeing the gore in full detail.

>e
Your Room
The majority of space in the room is taken up by the chest that you kept all your belongings in. Next to your makeshift "bed" is a small nightstand.

You can see Chest (closed) and Nightstand (on which are a lamp and a drawer (closed)) here.

>open chest
Inside the chest you see a neatly folded blue uniform that every new member to the colony wears amongst all of the other clothes you have been wearing on your journey.

You open Chest, revealing Uniform.

>open drawer
You open the drawer and see wrappers from the candy bars you smuggled onto the ship before you departed and inevitably ate within the first month, despite telling yourself you would save at least one for when you reached your destination. Under the wrappers you can see something made of plastic.

You open the drawer, revealing candy wrapper and ID card.

>take all
Uniform: Taken.
candy wrapper: Taken.
ID card: Taken.

>put on uniform
You pull on the comfortable outfit and get ready to leave your rocket for good.

You put on Uniform.

>walk w
Mid Deck
The interior of the rocketship is almost entirely white. Your room is on the east side. On the west side of the room is a small cubicle that leads to the bathroom.  On the other side of the room is a ladder leads to the flight deck above and a lower deck below. A brochure of the rocket is pinned onto the wall.

You can see Brochure here.

>walk w
Bathroom

* * *

>put on uniform
You pull on the comfortable outfit and get ready to leave your rocket for good.

You put on Uniform.

I beg your pardon?

>walk w
Mid Deck
The interior of the rocketship is almost entirely white. Your room is on the east side. On the west side of the room is a small cubicle that leads to the bathroom.  On the other side of the room is a ladder leads to the flight deck above and a lower deck below. A brochure of the rocket is pinned onto the wall.

You can see Brochure here.

>walk w
You've already done everything you have to in here today.

>walk d
Lower Deck
There is a hatch on the north side where you can leave the ship. The lower deck is large and filled with rooms you don't care about. There is a ladder where you climbed down from the mid deck.

You can see Ship door here.

>open door
It seems to be locked.

>unlock door with card
You unlock Ship door.

>walk n
(first opening Ship door)

parking lot
You look around you and see a surprising amount of vegetation. Its amazing how similar Xuria's atmosphere is to Earth's. You are in a parking lot for space ships. The lot is empty except for an old spaceplane. The crash site is where the radio antenna array was. A shame that its now burnt to a crisp after the crash. To the North you can see some buildings that almost certainly make up the colony.

You can see Ship door and Spaceplane (empty) here.

>examine spaceplane
It is a Boeing type 929-200, a triple-warp-drive ancient relic from decades past. you used to pilot that thing for a sketchy galactic freight operator years before I took a job with the government. You just can't kill that that thing, not even with years of neglect. They just don't build "em like they used to. This one seems to be in a relatively good condition, compared to the ones on your last job, at least.

>enter spaceplane
The door is partially disassembled. Even if you could get in, it's not flyable like this. Maybe if you knew where the parts were and how to put it back together...

>look
parking lot
You look around you and see a surprising amount of vegetation. Its amazing how similar Xuria's atmosphere is to Earth's. You are in a parking lot for space ships. The lot is empty except for an old spaceplane. The crash site is where the radio antenna array was. A shame that its now burnt to a crisp after the crash. To the North you can see some buildings that almost certainly make up the colony.

You can see Ship door and Spaceplane (empty) here.

>walk n
town square
You walk from your rocket to the center of the tiny scattering of buildings. To the west you can see a large white building with a large red cross near the roof. To the east there are small houses that seem to make up the residential area. To the North you see a regal looking building with the words "Town Hall" displayed over the doors. (possibility for more places to be added) You cannot see any other colonists in the immediate area.

>walk n
Town Hall
You walk from your rocket to the center of the tiny scattering of buildings. To the west you can see a large white building with a large red cross near the roof. To the east there are small houses that seem to make up the residential area. To the North you see a regal looking building with the words Town Hall displayed over the doors. You cannot see any other colonists in the immediate area.

You can see ComputerDesk here.

>walk s
town square
You walk from your rocket to the center of the tiny scattering of buildings. To the west you can see a large white building with a large red cross near the roof. To the east there are small houses that seem to make up the residential area. To the North you see a regal looking building with the words "Town Hall" displayed over the doors. (possibility for more places to be added) You cannot see any other colonists in the immediate area.

>walk e
Residential area
You walk towards the residential area hoping that you'll finally find someone else. Its kind of creepy that no one has come to greet you yet. As you approach the residential area you see a line of houses that are all the same except for the color. The houses closest to you are green, blue, and red. To the east is the town square.

>walk ne
You can't go that way.

>walk e
You can't go that way.

>walk se
You can't go that way.

>walk northeast
You can't go that way.

>walk north east
I only understood you as far as wanting to walk north.

>walk east
You can't go that way.

>walk east
You can't go that way.

* * *

>walk e
Residential area
You walk towards the residential area hoping that you'll finally find someone else. Its kind of creepy that no one has come to greet you yet. As you approach the residential area you see a line of houses that are all the same except for the color. The houses closest to you are green, blue, and red. To the east is the town square.

>walk e
Johnson's Hall
Hey! This is the same house as the one you saw on the doctors desk! Maybe he will be able to explain why you haven't seen a single person yet. You try to open the door and find it unlocked. You cautiously enter the building and call out a hesitant, " H-hello?" but you get no reply. The house is a single story with four different rooms. There is a kitchen/eating area to the north, two bedrooms to the east, a study to the west, and the exit is to the south.

You can see Bedroom door here.

>walk walk e
You can't see any such thing.

>walk e
You open the bedroom door and immediately regret your decision. On the bed in the middle of the room is who you assume to be the doctor and his family huddled together. They are all very clearly dead and have been for a while judging by the smell that just hit your nose. You back out of the room and slam the door shut. You wonder what the heck has happened to all of the people on Xuria.

>walk e
You refuse to enter that horrid room again.

>walk s
You can't go that way.

>walk w
Johnson's Office
You enter a room with a large desk that is much neater than the one in the doctor's office. On the desk you can see more pictures as well as a key attached to a lanyard.

>walk e
Johnson's Hall
Hey! This is the same house as the one you saw on the doctors desk! Maybe he will be able to explain why you haven't seen a single person yet. You try to open the door and find it unlocked. You cautiously enter the building and call out a hesitant, " H-hello?" but you get no reply. The house is a single story with four different rooms. There is a kitchen/eating area to the north, two bedrooms to the east, a study to the west, and the exit is to the south.

You can see Bedroom door here.

>walk e
You refuse to enter that horrid room again.

* * *

>walk e
Your Room
The majority of space in the room is taken up by the chest that you kept all your belongings in. Next to your makeshift "bed" is a small nightstand.

* * *

>walk n
(first opening Ship door)

parking lot
You look around you and see a surprising amount of vegetation. Its amazing how similar Xuria's atmosphere is to Earth's. You are in a parking lot for space ships. The lot is empty except for an old spaceplane. The crash site is where the radio antenna array was. A shame that its now burnt to a crisp after the crash. To the North you can see some buildings that almost certainly make up the colony.

You can see Ship door and Spaceplane (empty) here.

>walk n
town square
You walk from your rocket to the center of the tiny scattering of buildings. To the west you can see a large white building with a large red cross near the roof. To the east there are small houses that seem to make up the residential area. To the North you see a regal looking building with the words "Town Hall" displayed over the doors. (possibility for more places to be added) You cannot see any other colonists in the immediate area. You remember being told to go see a doctor of some sort so he can make sure you are still healthy after your long journey.

>walk n
Town Hall
You can see Portrait and Computer here.

You enter the regal building and see a wide room. There is a desk with a computer and an old book over in one corner. Behind the desk there is a portrait of a white haired man you remember seeing on the brochure for the colony. He is the leader of the colony if you remember correctly. There is a closet to the west.

>walk n
You can't go that way.

>examine computer
It's a UNIX system! I know this!

Enter username :

>examine Computer
Bad Username

>examine Computer desk
I only understood you as far as wanting to examine Computer.

>look
Town Hall
You walk from your rocket to the center of the tiny scattering of buildings. To the west you can see a large white building with a large red cross near the roof. To the east there are small houses that seem to make up the residential area. To the North you see a regal looking building with the words Town Hall displayed over the doors. You cannot see any other colonists in the immediate area.

You can see Computer, New Ship door and Old book here.

>examine computerdesk
You can't see any such thing.

>examine computer
It's a UNIX system! I know this!

Enter username :

>look at computer
Bad Username

>examine computer
It's a UNIX system! I know this!

Enter username :

>john12
Password :

* * *

>CoHoBaSt
john12@TownHall-02:/home/john12/$

>ls
At: /home/john12/
Contain folder: Download and Documents
Contain file: 

john12@TownHall-02:/home/john12/$

>cd Download
john12@TownHall-02:/home/john12/Download/$

>ls
At: /home/john12/Download/
Contain folder: B979Manual
Contain file: 

john12@TownHall-02:/home/john12/Download/$

>cd B979Manual
john12@TownHall-02:/home/john12/Download/B979Manual/$

>ls
At: /home/john12/Download/B979Manual/
Contain folder: 
Contain file: FCOM.txt and MxManual.txt

john12@TownHall-02:/home/john12/Download/B979Manual/$

>cat MxManual.txt
-----
Door should be installed with the up arrow pointing up and the inside label facing inside. Use No. 12 spanner to tighten the hinge bolt. Put grease (P/N:1102) onto the hinge. Do not use mayonaise for this task. Horseradish is not allowed, either.
-----
john12@TownHall-02:/home/john12/Download/B979Manual/$

* * *

>look at computer
Bad Username

>look
Town Hall
You walk from your rocket to the center of the tiny scattering of buildings. To the west you can see a large white building with a large red cross near the roof. To the east there are small houses that seem to make up the residential area. To the North you see a regal looking building with the words Town Hall displayed over the doors. You cannot see any other colonists in the immediate area.

You can see Computer and New Ship door here.

* * *

>look at computer
Bad Username

>examine old book
How to get chicks with Linux Part 38: Basic command line-fu 
 These are commands to show your prospective m'lady
 cd <folder name> - move into the folder <folder name> use "cd .. " to get out of the folder. 
 ls - list directories and files in the current folder.
 cat <filename> - read the target file. Ex. "cat blog.txt" shows the content of the file blog.txt. 
 Now we are ready for some real works. 
 
 And that's where the rest of the pages were torn off. "Getting chicks with Linux", huh? I almost grew a neckbeard just reading that.

* * *

>walk n
You can't go that way.

>take door
You can't see any such thing.

>walk s
town square
You walk from your rocket to the center of the tiny scattering of buildings. To the west you can see a large white building with a large red cross near the roof. To the east there are small houses that seem to make up the residential area. To the North you see a regal looking building with the words "Town Hall" displayed over the doors. (possibility for more places to be added) You cannot see any other colonists in the immediate area.

>walk s
parking lot
You look around you and see a surprising amount of vegetation. Its amazing how similar Xuria's atmosphere is to Earth's. You are in a parking lot for space ships. The lot is empty except for an old spaceplane. The crash site is where the radio antenna array was. A shame that its now burnt to a crisp after the crash. To the North you can see some buildings that almost certainly make up the colony.

You can see Ship door and Spaceplane (empty) here.

>examine spaceplane
It is a Boeing type 929-200, a triple-warp-drive ancient relic from decades past. you used to pilot that thing for a sketchy galactic freight operator years before I took a job with the government. You just can't kill that that thing, not even with years of neglect. They just don't build "em like they used to. This one seems to be in a relatively good condition, compared to the ones on your last job, at least.

>enter spaceplane
The door is partially disassembled. Even if you could get in, it's not flyable like this. Maybe if you knew where the parts were and how to put it back together...

parking lot
You look around you and see a surprising amount of vegetation. Its amazing how similar Xuria's atmosphere is to Earth's. You are in a parking lot for space ships. The lot is empty except for an old spaceplane. The crash site is where the radio antenna array was. A shame that its now burnt to a crisp after the crash. To the North you can see some buildings that almost certainly make up the colony.

You can see Ship door and Spaceplane (empty) here.

You get into Spaceplane.

>install door onto spaceplane
You haven't got that.

>enter spaceplane
The door is partially disassembled. Even if you could get in, it's not flyable like this. Maybe if you knew where the parts were and how to put it back together...

parking lot
You look around you and see a surprising amount of vegetation. Its amazing how similar Xuria's atmosphere is to Earth's. You are in a parking lot for space ships. The lot is empty except for an old spaceplane. The crash site is where the radio antenna array was. A shame that its now burnt to a crisp after the crash. To the North you can see some buildings that almost certainly make up the colony.

You can see Ship door and Spaceplane (empty) here.

You get into Spaceplane.

* * *

>take door
You can't see any such thing.

>walk e
You can't go that way.

>walk w
Town Hall closet
You open the door to find yourself in a small dimly lit closet. In the corner you can see a large door of some sort leaning against the wall. The only other things in the closet are cleaning supplies.

>take all
There are none at all available!

>take door
Taken.

* * *

>walk n
You can't go that way.

>walk e
You can't go that way.

>walk s
town square
You walk from your rocket to the center of the tiny scattering of buildings. To the west you can see a large white building with a large red cross near the roof. To the east there are small houses that seem to make up the residential area. To the North you see a regal looking building with the words "Town Hall" displayed over the doors. (possibility for more places to be added) You cannot see any other colonists in the immediate area. You remember being told to go see a doctor of some sort so he can make sure you are still healthy after your long journey.

>walk e
Residential area
You walk towards the residential area hoping that you'll finally find someone else. Its kind of creepy that no one has come to greet you yet. As you approach the residential area you see a line of houses that are all the same except for the color. The houses closest to you are green to the southeast, blue to the northeast, and red to the east. To the west is the town square.

>walk w
town square
You walk from your rocket to the center of the tiny scattering of buildings. To the west you can see a large white building with a large red cross near the roof. To the east there are small houses that seem to make up the residential area. To the North you see a regal looking building with the words "Town Hall" displayed over the doors. (possibility for more places to be added) You cannot see any other colonists in the immediate area. You remember being told to go see a doctor of some sort so he can make sure you are still healthy after your long journey.

>walk w
Hospital lobby
You enter the white building and discover that it is a hospital. There is a reception counter in the middle. You see a set of stairs leading up to a second floor to one side of the room. On a wall there is a bulletin board covered with papers. You can see some patient rooms to the North

You can see Reception counter here.

>walk w
You can't go that way.

>walk u
Hospital hallway
You walk up stairs to see a hallway of what are seemingly offices. At the end of the hall to the north there is a door that is slightly ajar.

* * *

>walk n
town square
You walk from your rocket to the center of the tiny scattering of buildings. To the west you can see a large white building with a large red cross near the roof. To the east there are small houses that seem to make up the residential area. To the North you see a regal looking building with the words "Town Hall" displayed over the doors. (possibility for more places to be added) You cannot see any other colonists in the immediate area. You remember being told to go see a doctor of some sort so he can make sure you are still healthy after your long journey.

>e
Residential area
You walk towards the residential area hoping that you'll finally find someone else. Its kind of creepy that no one has come to greet you yet. As you approach the residential area you see a line of houses that are all the same except for the color. The houses closest to you are green to the southeast, blue to the northeast, and red to the east. To the west is the town square.

* * *

>w
Residential area
You walk towards the residential area hoping that you'll finally find someone else. Its kind of creepy that no one has come to greet you yet. As you approach the residential area you see a line of houses that are all the same except for the color. The houses closest to you are green to the southeast, blue to the northeast, and red to the east. To the west is the town square.

>ne
Johnson's Hall
Hey! This is the same house as the one you saw on the doctors desk! Maybe he will be able to explain why you haven't seen a single person yet. You try to open the door and find it unlocked. You cautiously enter the building and call out a hesitant, " H-hello?" but you get no reply. The house is a single story with four different rooms. There is a kitchen/eating area to the north, two bedrooms, one to the southeast and the other to the east, a study to the west, and the exit is to the southwest.

You can see Bedroom door here.

>w
Johnson's Office
You enter a room with a large desk that is much neater than the one in the doctor's office. On the desk you can see more pictures as well as a key attached to a lanyard.

>take all
There are none at all available!

>take key
Taken.

>open drawer
You can't see any such thing.

>examine desk
You can't see any such thing.

>examine desk-drawer
You can't see any such thing.

>e
Johnson's Hall
Hey! This is the same house as the one you saw on the doctors desk! Maybe he will be able to explain why you haven't seen a single person yet. You try to open the door and find it unlocked. You cautiously enter the building and call out a hesitant, " H-hello?" but you get no reply. The house is a single story with four different rooms. There is a kitchen/eating area to the north, two bedrooms, one to the southeast and the other to the east, a study to the west, and the exit is to the southwest.

You can see Bedroom door here.

>look
Johnson's Hall
Hey! This is the same house as the one you saw on the doctors desk! Maybe he will be able to explain why you haven't seen a single person yet. You try to open the door and find it unlocked. You cautiously enter the building and call out a hesitant, " H-hello?" but you get no reply. The house is a single story with four different rooms. There is a kitchen/eating area to the north, two bedrooms, one to the southeast and the other to the east, a study to the west, and the exit is to the southwest.

You can see Bedroom door here.

>sw
Residential area
You walk towards the residential area hoping that you'll finally find someone else. Its kind of creepy that no one has come to greet you yet. As you approach the residential area you see a line of houses that are all the same except for the color. The houses closest to you are green to the southeast, blue to the northeast, and red to the east. To the west is the town square.

>w
town square
You walk from your rocket to the center of the tiny scattering of buildings. To the west you can see a large white building with a large red cross near the roof. To the east there are small houses that seem to make up the residential area. To the North you see a regal looking building with the words "Town Hall" displayed over the doors. (possibility for more places to be added) You cannot see any other colonists in the immediate area. You remember being told to go see a doctor of some sort so he can make sure you are still healthy after your long journey.