It is the year 2315, you are an astronaut who embarks on a journey a new planet, due to overpopulation and climate change destroying valuable resources on Earth. The planet is located in a different galaxy and accessible only through a wormhole. The planet, Xuria, has been found to be teeming with exotic plant life, quite habitable compared to Earth.

---------------------------------------------------------------------------------------------------------------

You can't believe you've finally made it. It seems like forever since you boarded the small rocket. Your journey from Earth to the planet Xuria has taken almost a year, even though you were traveling as close to light speed as is possible. You were chosen from random lottery to be sent to join the experimental colony on Xuria because Earth is falling apart due to climate change and dwindling resources. It is time to start your new life on this great new planet. However you should probably put on your gear first. There might be fire or sharp fragments of the ship outside after that rough landing.

Welcome
A Space Journey by Allen Chan, Kelsey Tweed, Tarun Nadimpalli, Woradorn Kamolpornwijit
Release 1 / Serial number 150417 / Inform 7 build 6L38 (I6/v6.33 lib 6/12N) SD

Mid Deck
The interior of the rocketship is almost entirely white. Your room is on the east side. On the west side of the room is a small cubicle that leads to the bathroom.  On the other side of the room is a ladder leads to the flight deck above and a lower deck below. A brochure of the rocket is pinned onto the wall.

>walk e
Your Room
The majority of space in the room is taken up by the chest that you kept all your belongings in. Next to your makeshift "bed" is a small nightstand.

>open drawer
You open the drawer and see wrappers from the candy bars you smuggled onto the ship before you departed and inevitably ate within the first month, despite telling yourself you would save at least one for when you reached your destination. Under the wrappers you can see something made of plastic.

You open the drawer, revealing candy wrapper and ID card.

>take all
candy wrapper: Taken.
ID card: Taken.

>walk w
Mid Deck
The interior of the rocketship is almost entirely white. Your room is on the east side. On the west side of the room is a small cubicle that leads to the bathroom.  On the other side of the room is a ladder leads to the flight deck above and a lower deck below. A brochure of the rocket is pinned onto the wall.

>walk d
Lower Deck
There is a ship door on the north side where you can leave the ship. The lower deck is large and filled with rooms you don't care about. There is a ladder where you climbed down from the mid deck.

You can see Ship door here.

>open door with card
You unlock Ship door.

>walk n
(first opening Ship door)

parking lot
You look around you and see a surprising amount of vegetation. Its amazing how similar Xuria's atmosphere is to Earth's. You are in a parking lot for space ships. The lot is empty except for an old spaceplane. The crash site is where the radio antenna array was. A shame that its now burnt to a crisp after the crash. To the North you can see some buildings that almost certainly make up the colony.

You can see Ship door and Spaceplane (empty) here.

>walk n
town square
You walk from your rocket to the center of the tiny scattering of buildings. To the west you can see a large white building with a large red cross near the roof. To the east there are small houses that seem to make up the residential area. To the North you see a regal looking building with the words "Town Hall" displayed over the doors. You cannot see any other colonists in the immediate area. You remember being told to go see a doctor of some sort so he can make sure you are still healthy after your long journey.

>w
Hospital lobby
You enter the white building and discover that it is a hospital. There is a reception counter in the middle. You see a set of stairs leading up to a second floor to one side of the room. On a wall there is a bulletin board covered with papers. You can see some patient rooms to the North

You can see Reception counter here.

>jump
OrangeDay:false, DeathRate:false, Computer:false, bedroom:false, KnowFixDoor: false

>x bulletin board
You take a closer look and see flyers and papers for a multitude of things. There are some displaying deals for space plant control and other services as well as a brightly colored flyer encouraging people to participate in Wear Orange to Work Day on 4/20

>jump
OrangeDay:true, DeathRate:false, Computer:false, bedroom:false, KnowFixDoor: false

>look
Hospital lobby
You enter the white building and discover that it is a hospital. There is a reception counter in the middle. You see a set of stairs leading up to a second floor to one side of the room. On a wall there is a bulletin board covered with papers. You can see some patient rooms to the North

You can see Reception counter here.

>x counter
The reception desk has many different files on it that look too important to touch. You cannot see the receptionist, or anyone else for that matter, in the immediate area.

>n
Patient room
You enter one of the patient rooms and see that it is full of various medical equipment. Off to one side you can see a gas tank that is labeled Tetrachloroethane.

>take tank
Taken.

>look
Patient room
You enter one of the patient rooms and see that it is full of various medical equipment. Off to one side you can see a gas tank that is labeled Tetrachloroethane.

>s
Hospital lobby
You enter the white building and discover that it is a hospital. There is a reception counter in the middle. You see a set of stairs leading up to a second floor to one side of the room. On a wall there is a bulletin board covered with papers. You can see some patient rooms to the North

You can see Reception counter here.

>u
Hospital hallway
You walk up stairs to see a hallway of what are seemingly offices. At the end of the hall to the north there is a door that is slightly ajar.

>n
Doctor's office
You can see desk-drawer (closed) and Desk here.

You approach the slightly open door and see a nameplate that reads Dr. Johnson next to it. You enter the office and your attention is immediately drawn to the wooden desk taking up most of the room. There are papers strewn all over it as well as a photo of a tall man and a woman and a child standing in front of a blue house that looks as though it is located on this planet. The only other furniture in the room is a bookcase filled with medical journals and other books with names you cannot pronounce.

>x desk
You rifle through the papers on the desk and see that they are mostly patient files. Further inspection reveals that many of the patients are seemingly suffering from the same disease. There are questions scrawled in barely legible handwriting on many of these files asking questions such as, "Who has infected, who this time?" and "Why weren't there as many deaths on 4/20?" Your closer inspection of the area has brought to your attention a desk-drawer on the other side of the desk.

>x desk-drawer
You try to open the drawer but it is locked. You wonder where the doctor could have left the key.

>s
Hospital hallway
You walk up stairs to see a hallway of what are seemingly offices. At the end of the hall to the north there is a door that is slightly ajar.

>d
Hospital lobby
You enter the white building and discover that it is a hospital. There is a reception counter in the middle. You see a set of stairs leading up to a second floor to one side of the room. On a wall there is a bulletin board covered with papers. You can see some patient rooms to the North

You can see Reception counter here.

>e
town square
You walk from your rocket to the center of the tiny scattering of buildings. To the west you can see a large white building with a large red cross near the roof. To the east there are small houses that seem to make up the residential area. To the North you see a regal looking building with the words "Town Hall" displayed over the doors. You cannot see any other colonists in the immediate area. You remember being told to go see a doctor of some sort so he can make sure you are still healthy after your long journey.

I beg your pardon?

>e
Residential area
You walk towards the residential area hoping that you'll finally find someone else. Its kind of creepy that no one has come to greet you yet. As you approach the residential area you see a line of houses that are all the same except for the color. The houses closest to you are green to the southeast, blue to the northeast, and red to the east. To the west is the town square.

>e
Red house
You approach the front door of the house and try to open the door only to find it locked. Its kind of sketchy to be trying to break into random people's houses you know…

>w
Residential area
You walk towards the residential area hoping that you'll finally find someone else. Its kind of creepy that no one has come to greet you yet. As you approach the residential area you see a line of houses that are all the same except for the color. The houses closest to you are green to the southeast, blue to the northeast, and red to the east. To the west is the town square.

>se
Green house
You approach the front door of the house and try to open the door only to find it locked. Its kind of sketchy to be trying to break into random people's houses you know…

>nw
Residential area
You walk towards the residential area hoping that you'll finally find someone else. Its kind of creepy that no one has come to greet you yet. As you approach the residential area you see a line of houses that are all the same except for the color. The houses closest to you are green to the southeast, blue to the northeast, and red to the east. To the west is the town square.

>ne
Johnson's Hall
Hey! This is the same house as the one you saw on the doctors desk! Maybe he will be able to explain why you haven't seen a single person yet. You try to open the door and find it unlocked. You cautiously enter the building and call out a hesitant, " H-hello?" but you get no reply. The house is a single story with four different rooms. There is a kitchen/eating area to the north, two bedrooms, one to the southeast and the other to the east, a study to the west, and the exit is to the southwest.

You can see Bedroom door here.

>se
(first opening Bedroom door)
The door that lead into the bedroom is slightly ajar and allows you to see an empty pink room that probably belongs to the girl you saw in the picture on the doctor's desk.
I don't think I should get in there, though.

>se
(first opening Bedroom door)
The door that lead into the bedroom is slightly ajar and allows you to see an empty pink room that probably belongs to the girl you saw in the picture on the doctor's desk.
I don't think I should get in there, though.

>look
Johnson's Hall
Hey! This is the same house as the one you saw on the doctors desk! Maybe he will be able to explain why you haven't seen a single person yet. You try to open the door and find it unlocked. You cautiously enter the building and call out a hesitant, " H-hello?" but you get no reply. The house is a single story with four different rooms. There is a kitchen/eating area to the north, two bedrooms, one to the southeast and the other to the east, a study to the west, and the exit is to the southwest.

You can see Bedroom door here.

>n
Johnson's Kitchen
You walk into the pristine kitchen and take a look around. You can see all of the basic kitchen appliances around the room. There is only one part of the room that seems out of place. There is a cupboard door missing for the compartment under the sink.

>x cupboard
You look under the sink into the cupboard and see a battered looking toolbox and some cleaning products.

>take toolbox
Taken.

>take cleaning product
I only understood you as far as wanting to take Cleaning products.

>take cleaning products
It only kills Earth's germs. Not very useful here.

>x cleaning product
I only understood you as far as wanting to examine Cleaning products.

>x cleaning products
"Kills 99% of germs!" Only Earth's germs, as it turns out. So much for truth in advertising.

>inventory
You are carrying:
  Toolbox
  gas tank (closed)
  ID card
  candy wrapper

>x toolbox
You take the toolbox and examine its contents. There are various tools that look like they would be useful if you had to fix something.

>look
Johnson's Kitchen
You walk into the pristine kitchen and take a look around. You can see all of the basic kitchen appliances around the room. There is only one part of the room that seems out of place. There is a cupboard door missing for the compartment under the sink.

>s
Johnson's Hall
Hey! This is the same house as the one you saw on the doctors desk! Maybe he will be able to explain why you haven't seen a single person yet. You try to open the door and find it unlocked. You cautiously enter the building and call out a hesitant, " H-hello?" but you get no reply. The house is a single story with four different rooms. There is a kitchen/eating area to the north, two bedrooms, one to the southeast and the other to the east, a study to the west, and the exit is to the southwest.

You can see Bedroom door here.

>e
You open the bedroom door and immediately regret your decision. On the bed in the middle of the room is who you assume to be the doctor and his family huddled together. They are all very clearly dead and have been for a while judging by the smell that just hit your nose. You back out of the room and slam the door shut. You wonder what the heck has happened to all of the people on Xuria.

>e
You refuse to enter that horrid room again.

>jump
OrangeDay:true, DeathRate:true, Computer:false, bedroom:true, KnowFixDoor: false

>look
Johnson's Hall
Hey! This is the same house as the one you saw on the doctors desk! Maybe he will be able to explain why you haven't seen a single person yet. You try to open the door and find it unlocked. You cautiously enter the building and call out a hesitant, " H-hello?" but you get no reply. The house is a single story with four different rooms. There is a kitchen/eating area to the north, two bedrooms, one to the southeast and the other to the east, a study to the west, and the exit is to the southwest.

You can see Bedroom door here.

>w
Johnson's Office
You enter a room with a large desk that is much neater than the one in the doctor's office. On the desk you can see more pictures as well as a key attached to a lanyard.

>x key
You see nothing special about Office key.

>take key
Taken.

>x desk
You can't see any such thing.

>e
Johnson's Hall
Hey! This is the same house as the one you saw on the doctors desk! Maybe he will be able to explain why you haven't seen a single person yet. You try to open the door and find it unlocked. You cautiously enter the building and call out a hesitant, " H-hello?" but you get no reply. The house is a single story with four different rooms. There is a kitchen/eating area to the north, two bedrooms, one to the southeast and the other to the east, a study to the west, and the exit is to the southwest.

You can see Bedroom door here.

>sw
Residential area
You walk towards the residential area hoping that you'll finally find someone else. Its kind of creepy that no one has come to greet you yet. As you approach the residential area you see a line of houses that are all the same except for the color. The houses closest to you are green to the southeast, blue to the northeast, and red to the east. To the west is the town square.

>w
town square
You walk from your rocket to the center of the tiny scattering of buildings. To the west you can see a large white building with a large red cross near the roof. To the east there are small houses that seem to make up the residential area. To the North you see a regal looking building with the words "Town Hall" displayed over the doors. You cannot see any other colonists in the immediate area. You remember being told to go see a doctor of some sort so he can make sure you are still healthy after your long journey.

>n
Town Hall
You can see Portrait and Computer here.

You enter the regal building and see a wide room. There is a desk with a computer and an old book over in one corner. Behind the desk there is a portrait of a white haired man you remember seeing on the brochure for the colony. He is the leader of the colony if you remember correctly. There is a closet to the west.

>x portrait
A white haired, solemn looking man stares out at you from the canvas he has been painted on. Creepy.

>x old book
How to get chicks with Linux Part 38: Basic command line-fu 
 These are commands to show your prospective m'lady
 WARNING: The system is CaSe-sEnsITivE! 
 cd <folder name> - move into the folder <folder name> use "cd .. " to get out of the folder. 
 ls - list directories and files in the current folder.
 cat <filename> - read the target file. Ex. "cat blog.txt" shows the content of the file blog.txt. 
 Now we are ready for some real works. 
 
 And that's where the rest of the pages were torn off. "Getting chicks with Linux", huh? I almost grew a neckbeard just by reading that.

>s
town square
You walk from your rocket to the center of the tiny scattering of buildings. To the west you can see a large white building with a large red cross near the roof. To the east there are small houses that seem to make up the residential area. To the North you see a regal looking building with the words "Town Hall" displayed over the doors. You cannot see any other colonists in the immediate area. You remember being told to go see a doctor of some sort so he can make sure you are still healthy after your long journey.

>w
Hospital lobby
You enter the white building and discover that it is a hospital. There is a reception counter in the middle. You see a set of stairs leading up to a second floor to one side of the room. On a wall there is a bulletin board covered with papers. You can see some patient rooms to the North

You can see Reception counter here.

>u
Hospital hallway
You walk up stairs to see a hallway of what are seemingly offices. At the end of the hall to the north there is a door that is slightly ajar.

* * *

>n
Doctor's office
You can see desk-drawer (closed) and Desk here.

You approach the slightly open door and see a nameplate that reads Dr. Johnson next to it. You enter the office and your attention is immediately drawn to the wooden desk taking up most of the room. There are papers strewn all over it as well as a photo of a tall man and a woman and a child standing in front of a blue house that looks as though it is located on this planet. The only other furniture in the room is a bookcase filled with medical journals and other books with names you cannot pronounce.

>open desk-drawer
It seems to be locked.

>unlock drawer
You can't see any such thing.

>unlock desk-drawer
What do you want to unlock desk-drawer with?

>key
You unlock desk-drawer.

>open desk-drawer
You take the key you got from the doctor's study and unlock the drawer. In the drawer you see a strange looking contraption that resemble goggles or an ancient machine called an Oculus rift that you once heard about in my history of technology class. This particular example seems to be in a poor condition: The plastic looks faded and the battery oozes strange chemical.

You open desk-drawer, revealing Goggles.

>take goggles
Taken.

>x goggles
You should try looking at your surroundings in a different perspective.

>put on goggles
You put on Goggles.

>look
Doctor's office
You can see desk-drawer (empty) and Desk here.

When the gogles on, you see a bunch of static at first but it eventually clears up long enough to show a first person view of someone looking at papers on the desk you are standing next to. You can hear some distorted sounds that you think are an occasional sigh or mumble of frustration. You focus on the papers the person is examining and see that they are patient files like the ones you were looking at earlier. You get a glimpse of how all life on the planet seems to hate bright colors. Suddenly the screen goes black.

>remove goggle
You can't see any such thing.

>remove goggles
You take off Goggles.

>s
Hospital hallway
You walk up stairs to see a hallway of what are seemingly offices. At the end of the hall to the north there is a door that is slightly ajar.

>put on goggles
You put on Goggles.

>look
Hospital hallway
You walk up stairs to see a hallway of what are seemingly offices. At the end of the hall to the north there is a door that is slightly ajar.

>d
Hospital lobby
You enter the white building and discover that it is a hospital. There is a reception counter in the middle. You see a set of stairs leading up to a second floor to one side of the room. On a wall there is a bulletin board covered with papers. You can see some patient rooms to the North

You can see Reception counter here.

>look
Hospital lobby
You enter the white building and discover that it is a hospital. There is a reception counter in the middle. You see a set of stairs leading up to a second floor to one side of the room. On a wall there is a bulletin board covered with papers. You can see some patient rooms to the North

You can see Reception counter here.

>n
Patient room
You enter one of the patient rooms and see that it is full of various medical equipment. Off to one side you can see a gas tank that is labeled Tetrachloroethane.

>s
Hospital lobby
You enter the white building and discover that it is a hospital. There is a reception counter in the middle. You see a set of stairs leading up to a second floor to one side of the room. On a wall there is a bulletin board covered with papers. You can see some patient rooms to the North

You can see Reception counter here.

>e
town square
You walk from your rocket to the center of the tiny scattering of buildings. To the west you can see a large white building with a large red cross near the roof. To the east there are small houses that seem to make up the residential area. To the North you see a regal looking building with the words "Town Hall" displayed over the doors. You cannot see any other colonists in the immediate area. You remember being told to go see a doctor of some sort so he can make sure you are still healthy after your long journey.

>n
Town Hall
You can see Portrait and Computer here.

The goggles immediately begin playing a blurry video. You see the leader of the colony with a concerned look on his face. Through the static you can hear the same voice you heard in the doctors office speaking with a frantic sound to his speech. You can only pick out a few words such as "disease, too many deaths, and can't find cure.". He turns on the computer and logged in. You saw the user name was "john12". He typed "CoHoBaSt" in as a password. "Correct Horse Battery Staple", he said. He quickly opened his blog post. The expression on the leader's face becomes more and more solemn until the goggles again go black.

>jump
OrangeDay:true, DeathRate:true, Computer:false, bedroom:true, KnowFixDoor: false

>x computer
It's a UNIX system! I know this!

Enter username :

>john12
Password :

>CoHoBaSt
john12@TownHall-02:/home/john12/$

>ls
At: /home/john12/
Contain folder: {"Download", "Documents"}
Contain file: {}

john12@TownHall-02:/home/john12/$

>cd Download
john12@TownHall-02:/home/john12/Download/$

>ls
At: /home/john12/Download/
Contain folder: {"B979Manual"}
Contain file: {}

john12@TownHall-02:/home/john12/Download/$

>cd B979Manual
john12@TownHall-02:/home/john12/Download/B979Manual/$

>ls
At: /home/john12/Download/B979Manual/
Contain folder: {}
Contain file: {"FCOM.txt", "MxManual.txt"}

john12@TownHall-02:/home/john12/Download/B979Manual/$

>cat MxManual.txt
-----
Door should be installed with the up arrow pointing up and the inside label facing inside. Use No. 12 spanner to tighten the hinge bolt. Put grease (P/N:1102) onto the hinge. Do not use mayonaise for this task. Horseradish is not allowed, either.
-----
john12@TownHall-02:/home/john12/Download/B979Manual/$

* * *

>jump
OrangeDay:true, DeathRate:true, Computer:false, bedroom:true, KnowFixDoor: false

>jump
OrangeDay:true, DeathRate:true, Computer:false, bedroom:true, KnowFixDoor: true

>x computer
It's a UNIX system! I know this!

Enter username :

* * *

>john12
Password :

>CoHoBaSt
john12@TownHall-02:/home/john12/Download/B979Manual/$

>ls
At: /home/john12/Download/B979Manual/
Contain folder: {}
Contain file: {"FCOM.txt", "MxManual.txt"}

john12@TownHall-02:/home/john12/Download/B979Manual/$

>cat FCOM.txt
-----
A very long text that sounds more and more familar as it brings back your memories from your freight dog days...
-----
john12@TownHall-02:/home/john12/Download/B979Manual/$

>cd .
Can't do that
john12@TownHall-02:/home/john12/Download/B979Manual/$

>cd ..
john12@TownHall-02:/home/john12/Download/$

>cd ..
john12@TownHall-02:/home/john12/$

>cd Documents
john12@TownHall-02:/home/john12/Documents/$

>ls
At: /home/john12/Documents/
Contain folder: {}
Contain file: {"BlogDraft.txt"}

john12@TownHall-02:/home/john12/Documents/$

>cat BlogDraft.txt
-----
... Just look at the death rate here. On the date 4/20, the number of death was suddenly zero. ... This may offer an important clue toward the cure for this bacteria. We may need to look into what happened on that day. TODO: Add tetrachloroethane test result after I finish the bacteria growth analysis. ...
-----
john12@TownHall-02:/home/john12/Documents/$

* * *

>jump
OrangeDay:true, DeathRate:true, Computer:false, bedroom:true, KnowFixDoor: true

>inventory
You are carrying:
  Goggles (being worn)
  Office key
  Toolbox
  gas tank (closed)
  ID card
  candy wrapper

>remove goggles
You take off Goggles.

>s
town square
You walk from your rocket to the center of the tiny scattering of buildings. To the west you can see a large white building with a large red cross near the roof. To the east there are small houses that seem to make up the residential area. To the North you see a regal looking building with the words "Town Hall" displayed over the doors. You cannot see any other colonists in the immediate area. You remember being told to go see a doctor of some sort so he can make sure you are still healthy after your long journey.

>s
parking lot
You look around you and see a surprising amount of vegetation. Its amazing how similar Xuria's atmosphere is to Earth's. You are in a parking lot for space ships. The lot is empty except for an old spaceplane. The crash site is where the radio antenna array was. A shame that its now burnt to a crisp after the crash. To the North you can see some buildings that almost certainly make up the colony.

You can see Ship door and Spaceplane (empty) here.

>install door
(onto Spaceplane)
(first taking Ship door)
That's fixed in place.

>install new ship door
You can't see any such thing.

>inventory
You are carrying:
  Goggles
  Office key
  Toolbox
  gas tank (closed)
  ID card
  candy wrapper

>n
town square
You walk from your rocket to the center of the tiny scattering of buildings. To the west you can see a large white building with a large red cross near the roof. To the east there are small houses that seem to make up the residential area. To the North you see a regal looking building with the words "Town Hall" displayed over the doors. You cannot see any other colonists in the immediate area. You remember being told to go see a doctor of some sort so he can make sure you are still healthy after your long journey.

>n
Town Hall
You can see Portrait and Computer here.

You enter the regal building and see a wide room. There is a desk with a computer and an old book over in one corner. Behind the desk there is a portrait of a white haired man you remember seeing on the brochure for the colony. He is the leader of the colony if you remember correctly. There is a closet to the west.

* * *

>look
Town Hall
You can see Portrait and Computer here.

The goggles immediately begin playing a blurry video. You see the leader of the colony with a concerned look on his face. Through the static you can hear the same voice you heard in the doctors office speaking with a frantic sound to his speech. You can only pick out a few words such as "disease, too many deaths, and can't find cure.". He turns on the computer and logged in. You saw the user name was "john12". He typed "CoHoBaSt" in as a password. "Correct Horse Battery Staple", he said. He quickly opened his blog post. The expression on the leader's face becomes more and more solemn until the goggles again go black.

>remove goggles
You take off Goggles.

>look
Town Hall
You can see Portrait and Computer here.

You enter the regal building and see a wide room. There is a desk with a computer and an old book over in one corner. Behind the desk there is a portrait of a white haired man you remember seeing on the brochure for the colony. He is the leader of the colony if you remember correctly. There is a closet to the west.

>w
Town Hall closet
You open the door to find yourself in a small dimly lit closet. In the corner you can see a large door of some sort leaning against the wall. The only other things in the closet are cleaning supplies.

>take door
Taken.

>take cleaning supplies
Who do you think you are? A space janitor?

>inventory
You are carrying:
  New Ship door
  Goggles
  Office key
  Toolbox
  gas tank (closed)
  ID card
  candy wrapper

>e
Town Hall
You can see Portrait and Computer here.

You enter the regal building and see a wide room. There is a desk with a computer and an old book over in one corner. Behind the desk there is a portrait of a white haired man you remember seeing on the brochure for the colony. He is the leader of the colony if you remember correctly. There is a closet to the west.

>s
town square
You walk from your rocket to the center of the tiny scattering of buildings. To the west you can see a large white building with a large red cross near the roof. To the east there are small houses that seem to make up the residential area. To the North you see a regal looking building with the words "Town Hall" displayed over the doors. You cannot see any other colonists in the immediate area. You remember being told to go see a doctor of some sort so he can make sure you are still healthy after your long journey.

* * *

>s
parking lot
You look around you and see a surprising amount of vegetation. Its amazing how similar Xuria's atmosphere is to Earth's. You are in a parking lot for space ships. The lot is empty except for an old spaceplane. The crash site is where the radio antenna array was. A shame that its now burnt to a crisp after the crash. To the North you can see some buildings that almost certainly make up the colony.

You can see Ship door and Spaceplane (empty) here.

>install door
(New Ship door onto Spaceplane)
That was a quick fix.

>enter spaceplane
As you slide yourself into the pilot seat, you second guess your own decision. If this space virus make it's way back to Earth, the human civilization would instantly be over. Should you do it ... 
You left the spaceplane to clear your mind.

parking lot
You look around you and see a surprising amount of vegetation. Its amazing how similar Xuria's atmosphere is to Earth's. You are in a parking lot for space ships. The lot is empty except for an old spaceplane. The crash site is where the radio antenna array was. A shame that its now burnt to a crisp after the crash. To the North you can see some buildings that almost certainly make up the colony.

You can see Ship door and Spaceplane (empty) here.

>enter spaceplane
"There are arguments for and against doing this." 
You left the spaceplane to clear your mind.

parking lot
You look around you and see a surprising amount of vegetation. Its amazing how similar Xuria's atmosphere is to Earth's. You are in a parking lot for space ships. The lot is empty except for an old spaceplane. The crash site is where the radio antenna array was. A shame that its now burnt to a crisp after the crash. To the North you can see some buildings that almost certainly make up the colony.

You can see Ship door and Spaceplane (empty) here.

>enter spaceplane
*** You made your mind. Eradicating modern civilization is not exactly a decision one would made lightly, but it might be exactly what the civilization needs to rebuild itself. The problem, after all, was caused by overpopulation. This modern black death, or "orange death" (painful decision have its way of causing bad puns), could be the magic bullet needed for recovery and reconstruction. Your hand reached to the overhead panel. The auxiliary power unit whirled to life. The indicators and gauges lit up. It was not long before the navigation computers are programmed and the wormhole generators spooled up to life. The plane clicks and clatter to lifelife as she takes off. You crossed your fingers as the autopilot took over. It's going to be a long trip...  ***

Would you like to RESTART, RESTORE a saved game, QUIT or UNDO the last command?

* * *

>enter spaceplane
"There are arguments for and against doing this." 
You left the spaceplane to clear your mind.

parking lot
You look around you and see a surprising amount of vegetation. Its amazing how similar Xuria's atmosphere is to Earth's. You are in a parking lot for space ships. The lot is empty except for an old spaceplane. The crash site is where the radio antenna array was. A shame that its now burnt to a crisp after the crash. To the North you can see some buildings that almost certainly make up the colony.

You can see Ship door and Spaceplane (empty) here.

>open gas tank
The gas spread around the plane, killing all bacteria.

>enter spaceplane
*** Ahh, the nice smell of tetrachloroethane in the morning. This plane should be clean by now. You switched the cabin air control back to auto. Better get the show on the road before anything bad happens on Earth. We have no time to waste here. Your hand reached to the overhead panel. The auxiliary power unit whirled to life. The indicators and gauges lit up. It was not long before the navigation computers are programmed and the wormhole generators spooled up to life. The plane clicks and clatter to life as she takes off. You crossed your fingers as the autopilot took over. It's going to be a long trip...  ***

Would you like to RESTART, RESTORE a saved game, QUIT or UNDO the last command?

* * *

>jump
Might as well jump. Jump! Go ahead, jump!  Go ahead aaand jump. 
1980"s music goes together so well with space exploration.

>jump
*** In response to a complain recieved under the United States DMCA, we have to remove the rest of this game due to the recent copyright violation of the song Jump by Van Halen. We apologize that we have to cut short your experience with this game. 

Or so our lawyers said. Whatever, we (the REAL developer team) don't care. Just type undo (and don't tell our legal team about our advice: If they ask, play dumb!). ***

Would you like to RESTART, RESTORE a saved game, QUIT or UNDO the last command?

* * *

>go east
Your Room
The majority of space in the room is taken up by the chest that you kept all your belongings in. Next to your makeshift "bed" is a small nightstand.

>open chest
Inside the chest you see a neatly folded blue uniform that every new member to the colony wears amongst all of the other clothes you have been wearing on your journey.

You open Chest, revealing Uniform.

>take uniform
Taken.

>wear uniform
You pull on the comfortable outfit and get ready to leave your rocket for good.

You put on Uniform.

>examine nightstand
The nightstand is a small table with a single drawer. It has a small lamp which is providing light for the tiny room.

>open drawer
You open the drawer and see wrappers from the candy bars you smuggled onto the ship before you departed and inevitably ate within the first month, despite telling yourself you would save at least one for when you reached your destination. Under the wrappers you can see something made of plastic.

You open the drawer, revealing candy wrapper and ID card.

>take ID card
Taken.

>go west
Mid Deck
The interior of the rocketship is almost entirely white. Your room is on the east side. On the west side of the room is a small cubicle that leads to the bathroom.  On the other side of the room is a ladder leads to the flight deck above and a lower deck below. A brochure of the rocket is pinned onto the wall.

>go down
Lower Deck
There is a ship door on the north side where you can leave the ship. The lower deck is large and filled with rooms you don't care about. There is a ladder where you climbed down from the mid deck.

You can see Ship door here.

>unlock door with ID card
You unlock Ship door.

>go north
(first opening Ship door)

parking lot
You look around you and see a surprising amount of vegetation. Its amazing how similar Xuria's atmosphere is to Earth's. You are in a parking lot for space ships. The lot is empty except for an old spaceplane. The crash site is where the radio antenna array was. A shame that its now burnt to a crisp after the crash. To the North you can see some buildings that almost certainly make up the colony.

You can see Ship door and Spaceplane (empty) here.

>go north
town square
You walk from your rocket to the center of the tiny scattering of buildings. To the west you can see a large white building with a large red cross near the roof. To the east there are small houses that seem to make up the residential area. To the North you see a regal looking building with the words "Town Hall" displayed over the doors. You cannot see any other colonists in the immediate area. You remember being told to go see a doctor of some sort so he can make sure you are still healthy after your long journey.

>n
Town Hall
You can see Portrait and Computer here.

You enter the regal building and see a wide room. There is a desk with a computer and an old book over in one corner. Behind the desk there is a portrait of a white haired man you remember seeing on the brochure for the colony. He is the leader of the colony if you remember correctly. There is a closet to the west.

>n
You can't go that way.

>x computer
It's a UNIX system! I know this!

Enter username :

* * *

>ls
At: /home/john12/
Contain folder: {"Download", "Documents"}
Contain file: {}

john12@TownHall-02:/home/john12/$

>cd Documents
john12@TownHall-02:/home/john12/Documents/$

* * *

>cat BlogDraft.txt
-----
... Just look at the death rate here. On the date 4/20, the number of death was suddenly zero. ... This may offer an important clue toward the cure for this bacteria. We may need to look into what happened on that day. TODO: Add tetrachloroethane test result after I finish the bacteria growth analysis. ...
-----
john12@TownHall-02:/home/john12/Documents/$

>cd ..
john12@TownHall-02:/home/john12/$