Please examine the computer.

Reference Computer implementation
An Interactive Fiction by Woradorn K.
Release 1 / Serial number 150403 / Inform 7 build 6L38 (I6/v6.33 lib 6/12N) SD

RoomA
Go play with the computer already!

>examine computer
Welcome to the Handbook for Exemplary Learning Practices. In order to logon to this terminal, you'll need to enter the correct password.

guest@HELP:/home/guest/$

>examine HELP computer
You can't see any such thing.

>look
RoomA

* * *

>examine computer
Welcome to the Handbook for Exemplary Learning Practices. In order to logon to this terminal, you'll need to enter the correct password.

guest@HELP:/home/guest/$

>lol
CMD: lol Param: 
wtf?
That's not a verb I recognise.

guest@HELP:~$

>exit
But you aren't in anything at the moment.

* * *

>lol
CMD: lol Param: 
wtf?
That's not a verb I recognise.

guest@HELP:~$

>exit this
I only understood you as far as wanting to exit.

$

* * *

>examine computer
Welcome to the Handbook for Exemplary Learning Practices. In order to logon to this terminal, you'll need to enter the correct password.

guest@HELP:/home/guest/$

>exit this
I only understood you as far as wanting to exit.

$

>exit
But you aren't in anything at the moment.

$

* * *

>examine computer
Welcome to the Handbook for Exemplary Learning Practices. In order to logon to this terminal, you'll need to enter the correct password.

$

* * *

>exit
But you aren't in anything at the moment.

* * *

>examine computer
Welcome to the Handbook for Exemplary Learning Practices. In order to logon to this terminal, you'll need to enter the correct password.

guest@HELP:/home/guest/$

>vi
That's not a verb I recognise.

guest@HELP:~$

>emacs
vi master race.

$

>emacs this.txt
vi master race.

$

* * *

>examine computer
Welcome to the Handbook for Exemplary Learning Practices. In order to logon to this terminal, you'll need to enter the correct password.

guest@HELP:/home/guest/$

>echo
echo
$

>echo this
echo this
$

* * *

>examine computer
Welcome to the Handbook for Exemplary Learning Practices. In order to logon to this terminal, you'll need to enter the correct password.

guest@HELP:/home/guest/$

>echo this
AyyLmao this--echo
guest@HELP:~$

>echo
echo
$

* * *

>echo this
AyyLmao this--echo
guest@HELP:~$

>echo echo echo
echo
$

* * *

>examine computer
Welcome to the Handbook for Exemplary Learning Practices. In order to logon to this terminal, you'll need to enter the correct password.

guest@HELP:/home/guest/$

>help
CMD: help Param: 
wtf?

guest@HELP:~$

>fuck this
CMD: fuck Param:  this
guest@HELP:~$

* * *

>help
CMD: help Param: 
wtf?

guest@HELP:~$

>emacs
CMD: emacs Param: 
vi master race.

guest@HELP:~$

* * *

>examine computer
Welcome to the Handbook for Exemplary Learning Practices. In order to logon to this terminal, you'll need to enter the correct password.

guest@HELP:/home/guest/$

>emacs
CMD: emacs Param: 
vi master race.

guest@HELP:~$

* * *

>examine computer
Welcome to the Handbook for Exemplary Learning Practices. In order to logon to this terminal, you'll need to enter the correct password.

guest@HELP:/home/guest/$

>this
CMD: this Param: \n
guest@HELP:~$

* * *

>examine computer
Welcome to the Handbook for Exemplary Learning Practices. In order to logon to this terminal, you'll need to enter the correct password.

guest@HELP:/home/guest/$

>cd test
CMD: cd Param:  test

guest@HELP:~$

>cd ..
CMD: cd Param:  ..

guest@HELP:$

* * *

>examine computer
Welcome to the Handbook for Exemplary Learning Practices. In order to logon to this terminal, you'll need to enter the correct password.

guest@HELP:/home/guest/$

>inventory
CMD: inventory Param: 
wtf?

guest@HELP:~$

>vi
CMD: vi Param: 
emacs master race.

guest@HELP:~$

>emacs
CMD: emacs Param: 
vi master race.

guest@HELP:~$

* * *

>examine computer
Welcome to the Handbook for Exemplary Learning Practices. In order to logon to this terminal, you'll need to enter the correct password.

guest@HELP:/home/guest/$

>cd pr0nstash
CMD: cd Param:  pr0nstash

guest@HELP:~$

* * *

>examine computer
Welcome to the Handbook for Exemplary Learning Practices. In order to logon to this terminal, you'll need to enter the correct password.

guest@HELP:/home/guest/$

>cd aaa
CMD: cd Param:  aaa
/ aaa
guest@HELP:/$

* * *

>examine computer
Welcome to the Handbook for Exemplary Learning Practices. In order to logon to this terminal, you'll need to enter the correct password.

guest@HELP:/home/guest/$

>cd pr0n
CMD: cd Param: pr0n
{"home", "guest", "PEN15"}cd done
guest@HELP:/home, guest / PEN15$

>cd pr0n
CMD: cd Param: pr0n
/pr0n
guest@HELP:/$

>cd ..
CMD: cd Param: ..

guest@HELP:/$

* * *

>cd pr0n
CMD: cd Param: pr0n
{"home", "guest", "PEN15"}cd done
guest@HELP:/home, guest / PEN15$

>cd pr)n
CMD: cd Param: pr)n
{503194, 503194}cd done
guest@HELP:/503194 / 503194$

* * *

>examine computer
Welcome to the Handbook for Exemplary Learning Practices. In order to logon to this terminal, you'll need to enter the correct password.

guest@HELP:/home/guest/$

>cd ..
guest@HELP:/home/$

>cd pr0n
CMD: cd Param: pr0n
/pr0ncd done
guest@HELP:/$

>cd pr0n/lel
CMD: cd Param: pr0n/lel
/pr0n/lelcd done
guest@HELP:/$

* * *

>cd ..
guest@HELP:/home/$

>ls
At: /home/
Contain folder: guest
Contain file: 

guest@HELP:/home/$

* * *

>examine computer
Welcome to the Handbook for Exemplary Learning Practices. In order to logon to this terminal, you'll need to enter the correct password.

guest@HELP:/home/guest/$

>cd pr)n
CMD: cd Param: pr)n
/pr)ncd done
guest@HELP:/$

>cd pr)n
CMD: cd Param: pr)n
/pr)ncd done
guest@HELP:/$

>cd pr0n
CMD: cd Param: pr0n
/pr0ncd done
guest@HELP:/$

* * *

>examine computer
Welcome to the Handbook for Exemplary Learning Practices. In order to logon to this terminal, you'll need to enter the correct password.

guest@HELP:/home/guest/$

>cd that
CMD: cd Param: that
{"this", "PEN15"}cd done
guest@HELP:/this / PEN15$

* * *

>examine computer
Welcome to the Handbook for Exemplary Learning Practices. In order to logon to this terminal, you'll need to enter the correct password.

guest@HELP:/home/guest/$

>cd pron
CMD: cd Param: pron
{"home", "guest", "pron"}cd done
guest@HELP:home/guest/pron/$

>cd horsePron
CMD: cd Param: horsePron
{"home", "guest", "pron", "horsePron"}cd done
guest@HELP:home/guest/pron/horsePron/$

* * *

>examine computer
Welcome to the Handbook for Exemplary Learning Practices. In order to logon to this terminal, you'll need to enter the correct password.

guest@HELP:/home/guest/$

>cd horsePr0n
CMD: cd Param: horsePr0n
cd done
guest@HELP:/home/guest/horsePr0n/$

>cd ..
CMD: cd Param: ..
cd done
guest@HELP:/home/guest/$

* * *

>examine computer
Welcome to the Handbook for Exemplary Learning Practices. In order to logon to this terminal, you'll need to enter the correct password.

guest@HELP:/home/guest/$

>cd .
CMD: cd Param: .
{"home", "guest", "."}cd done
guest@HELP:/home/guest/./$

>cd ..
CMD: cd Param: ..
home and guestcd done
guest@HELP:/home/guest/$

>cd ..
CMD: cd Param: ..
homecd done
guest@HELP:/home/$

* * *

>examine computer
Welcome to the Handbook for Exemplary Learning Practices. In order to logon to this terminal, you'll need to enter the correct password.

guest@HELP:/home/guest/$

>ls
CMD: ls Param: 
At: /home/guest/
Contain folder: Download and Documents
Contain file: diary.txt

guest@HELP:/home/guest/$

>cd horsePr0n
CMD: cd Param: horsePr0n

guest@HELP:/home/guest/$

>cd Download
CMD: cd Param: Download

guest@HELP:/home/guest/Download/$

>ls
CMD: ls Param: 
At: /home/guest/Download/

*** Run-time problem P21: Attempt to look up a non-existent correspondence in the table 'Table of fileInDir'.

Contain folder: guest
Contain file: 

guest@HELP:/home/guest/Download/$

* * *

>ls
CMD: ls Param: 
At: /home/guest/
Contain folder: Download and Documents
Contain file: diary.txt

guest@HELP:/home/guest/$

>cd Download
CMD: cd Param: Download

guest@HELP:/home/guest/Download/$

>ls
CMD: ls Param: 
At: /home/guest/Download/
Contain folder: 
Contain file: 

guest@HELP:/home/guest/Download/$

* * *

>examine computer
Welcome to the Handbook for Exemplary Learning Practices. In order to logon to this terminal, you'll need to enter the correct password.

guest@HELP:/home/guest/$

>dir
At: /home/guest/
Contain folder: Download and Documents
Contain file: diary.txt

guest@HELP:/home/guest/$

* * *

Please examine the computer.

Reference Computer implementation
An Interactive Fiction by Woradorn K.
Release 1 / Serial number 150403 / Inform 7 build 6L38 (I6/v6.33 lib 6/12N) SD

RoomA
Go play with the computer already!

>examine help computer
Welcome to the Handbook for Exemplary Learning Practices. In order to logon to this terminal, you'll need to enter the correct password.

$

>exit
But you aren't in anything at the moment.

$

* * *

>examine help computer
Welcome to the Handbook for Exemplary Learning Practices. In order to logon to this terminal, you'll need to enter the correct password.

$

>lol
That's not a verb I recognise.

$

* * *

Please examine the computer.

Reference Computer implementation
An Interactive Fiction by Woradorn K.
Release 1 / Serial number 150403 / Inform 7 build 6L38 (I6/v6.33 lib 6/12N) SD

RoomA
Go play with the computer already!

>examione computer
That's not a verb I recognise.

>examine computer
Welcome to the Handbook for Exemplary Learning Practices. In order to logon to this terminal, you'll need to enter the correct password.

$

>echo this
echo this
$

* * *

Please examine the computer.

Reference Computer implementation
An Interactive Fiction by Woradorn K.
Release 1 / Serial number 150403 / Inform 7 build 6L38 (I6/v6.33 lib 6/12N) SD

RoomA
Go play with the computer already!

>exit
But you aren't in anything at the moment.

>examine computer
Welcome to the Handbook for Exemplary Learning Practices. In order to logon to this terminal, you'll need to enter the correct password.

guest@HELP:~$

* * *

Please examine the computer.

Reference Computer implementation
An Interactive Fiction by Woradorn K.
Release 1 / Serial number 150403 / Inform 7 build 6L38 (I6/v6.33 lib 6/12N) SD

RoomA
Go play with the computer already!

>emacs
That's not a verb I recognise.

>examine computer
Welcome to the Handbook for Exemplary Learning Practices. In order to logon to this terminal, you'll need to enter the correct password.

guest@HELP:~$

>emacs
vi master race.

guest@HELP:~$

>echo
echo
guest@HELP:~$

* * *

Please examine the computer.

Reference Computer implementation
An Interactive Fiction by Woradorn K.
Release 1 / Serial number 150403 / Inform 7 build 6L38 (I6/v6.33 lib 6/12N) SD

RoomA
Go play with the computer already!

>xamine computer
That's not a verb I recognise.

>examine computer
Welcome to the Handbook for Exemplary Learning Practices. In order to logon to this terminal, you'll need to enter the correct password.

guest@HELP:/$

>cd pr0n
CMD: cd Param: pr0n
{503194}cd done
guest@HELP:/503194$

>cd pr0n
CMD: cd Param: pr0n
{503194, 503194}cd done
guest@HELP:/503194 and 503194$

* * *

Please examine the computer.

Reference Computer implementation
An Interactive Fiction by Woradorn K.
Release 1 / Serial number 150403 / Inform 7 build 6L38 (I6/v6.33 lib 6/12N) SD

RoomA
Go play with the computer already!

>look
RoomA
Go play with the computer already!